  WWWTTTWWWTTTWWWTTTWWWTTTWWWTTTWWWTTTWWWTTTWWWTTTWWWTTTWWW
  W                          W       W                    W
  T                          W WWWWW W                    T
  T                          W   W   W                    T
  T                          WWW W WWW                    T
  T                        W W   W   W W                  T
  WWWW          GGGG       W W WWWWW W W               WWWW
  T                        W W   W   W W                  T
  T                        W WWW W WWW W                  T
  T                       GW   W W W   WG                 T
  T                       GW W W W W W WG                 T
  W                       GW W   W   W WG                 W
  WWWWWWWWWWWWWWWWWWWWWWWWWWWWWWWWWWWWWWWWWWWWWWWWWWWWWWWWW