W         WWWWWWWWWWWWWWWWWWWWWWWWWWWWWWWWWWWWWWWWWWWWWWWWWWWWWWWWWW
          W                                                        W
W         T                                                        T
          T                                                        T
W  W      T                                                        T
   W      T             G G G G                                    T
W  W      T             G                                          T
          T             G                                          T
W         T                                                        T
          T                                                        T
W         T                                                        T
          W                                                        W
W         WWWWWWWWWWWWWWWWWWWWWWWWWWWWWWWWWWWWWWWWWWWWWWWWWWWWWWWWWW