W         WWWWWWWWWWWWWWWWWWWWWWWWWWWWWWWWWWWWWWWWWWWWWWWWWWWWWWWWWW
          W                                                        W
W         T                                                        T
          T                                                        T
W  W      T                                                        T
   W      T             G                                          T
W  W      T                                                        T
          T                                                        T
W         T                                                        T
          T                                                        T
W         T                                                        T
          W                                                        W
W         WWWWWWWWWWWWWWWWWWWWWWWWWWWWWWWWWWWWWWWWWWWWWWWWWWWWWWWWWW